泰山路	4号线
利津路	无换乘
台东	1号线
海信桥	无换乘
芝泉路	无换乘
五四广场	3号线
浮山所	无换乘
燕儿岛路	无换乘
高雄路	无换乘
麦岛站	无换乘
海游路	无换乘
海川路	无换乘
海安路	无换乘
石老人浴场	无换乘
苗岭路	无换乘
同安路	无换乘
辽阳东路	4号线
东韩	无换乘
华楼山路	无换乘
枣山路	无换乘
李村	3号线
李村公园	无换乘
夏庄路	无换乘
下王埠	无换乘
佛耳崖	无换乘
长涧	无换乘
臧村	无换乘
李家上流	无换乘
王家上流	无换乘
世博园	无换乘
