青岛站	1号线
人民会堂	4号线
汇泉广场	无换乘
中山公园	无换乘
太平角公园	无换乘
延安三路	无换乘
五四广场	2号线
江西路	无换乘
宁夏路	无换乘
敦化路	无换乘
错埠岭	无换乘
清江路	无换乘
双山	无换乘
长沙路	无换乘
地铁大厦	无换乘
海尔路	无换乘
万年泉路	无换乘
李村	无换乘
君峰路	无换乘
振华路	无换乘
永平路	无换乘
青岛北站	1号线
