人民会堂	3号线
青医附院	无换乘
江苏路	1号线
泰山路	2号线
昌邑路	无换乘
内蒙古路	无换乘
海波桥	1号线
鞍山路	无换乘
错埠岭	3号线
福州路	无换乘
洪山坡	无换乘
劲松三路	无换乘
劲松四路	无换乘
劲松七路	无换乘
辽阳东路	2号线
李家下庄	无换乘
崂山科技城	无换乘
张村	无换乘
李宅路	无换乘
九水东路	无换乘
沙子口	无换乘
